
EA pikachu.xpm
F 50 100 4
C 254 87 254
CT espace.xpm

R 1200 1200


NO wood2.xpm

SO wood.xpm


WE redbrick.xpm
S pupitre.xpm
11111111111111111111111111111111111
12000000000000000012000000000000021
11111111011111111111113111111111111
100000000022222000000E0021010000001
11111111111102222200000011200000001
11000001101111111111000002100000001
11111111111000000121000001000000001
10000000000000000000011111111111111
13111113111113111113311000100010001
10111110111110111110011010101010101
10111110111110111110011010101010101
10000010000010200210011010101010101
10000010000010000010011010101010101
10222210000010000010010010101010101
10000010000010000010010210001000101
10222210000010000010011111111111101
10000010000010000011000000000000001
11111111111111111111111111111111111
