
F (88, 41, 0)


EA textures/bois4.xpm
C 255 255 255
R 1097 1200
NO textures/wood2.xpm

SO textures/wood.xpm

P textures/woodporte.xpm
CT textures/espace.xpm

WE textures/bois3.xpm
S textures/sprite.xpm


11111111111111111111111111111111111
12000000000000000012000000000000021
11111111011111111111110111111111111
10000000002222200000000021010000001
11111111111102222200001112000000001
11000001101111111111000021000000001
11111111111000000121000001000000001
10000000000000000000000000000000001
1000000000000000000000000000W000001
10000000000000000000000000001000001
10000000000000000000000000000000001
10000000001100000000000000000000001
10000000001220000000000000000000001
10000000001100000000000000000000001
10000000000000000000000000000000001
10000000000000000000000000000000001
10000000000000000000000000000000001
10000000000000000000011111111111111
10111110111110111110011000100010001
10111110111110111110011010101010101
10111110111110111110011010101010101
10000010000010200210011010101010101
10000010000010000010011010101010101
10222210000010000010010010101010101
10000010000010000010010210001000101
10222210000010000010011111111111101
10000010000010000011000000000000001
11111111111111111111111111111111111
