F 88 41 5

EA textures/bois4.xpm


C 190 190 190

R 1200 1200

NO textures/wood2.xpm

SO textures/wood.xpm

P textures/woodporte.xpm

WE textures/bois3.xpm

S textures/arbresprite.xpm

11111111111111111111111111111111111
11000000000000000011000000000000011
11111111011111111111110111111111111
10000000000000000000000001010000201
11111111111100000000111120000000001
11000001101111111100000001000000001
11111111111200000101000001000000001
10000000000000000000000000000000001
1000000000000000002000000000N000001
11111111111111111111111111111111111
